2,2
######################
#....................#
#....................#
#................##D#####
#................#......#
#................#......#
#................#......#
#................##D#####
#....................#
#....................#
######################